map = [ [ '#', ' ', ' ', '#', '#', '#', '#', ' ', '#', '#', '#', '#', ' ', ' ', '#', '#', '#', ' ', '#', '#', ' ', ' ', '#', '#', '#',  ],
[ '#', '#', ' ', '#', '#', '#', ' ', ' ', ' ', ' ', '#', ' ', '#', ' ', ' ', ' ', ' ', '#', '#', ' ', '#', '#', ' ', ' ', '#',  ],
[ ' ', ' ', '#', '#', ' ', ' ', ' ', ' ', ' ', '#', '#', '#', '#', ' ', ' ', '#', '#', ' ', ' ', ' ', ' ', ' ', '#', '#', ' ',  ],
[ '#', ' ', ' ', ' ', '#', '#', ' ', ' ', '#', '#', ' ', '#', '#', '#', ' ', '#', '#', ' ', ' ', '#', ' ', '#', ' ', ' ', ' ',  ],
[ '#', ' ', ' ', '#', ' ', '#', ' ', ' ', '#', ' ', ' ', ' ', ' ', ' ', '#', '#', ' ', ' ', ' ', ' ', ' ', '#', '#', ' ', '#',  ],
[ '#', '#', '#', '#', ' ', '#', ' ', '#', '#', '#', '#', '#', '#', ' ', '#', ' ', '#', ' ', ' ', '#', '#', '#', '#', ' ', ' ',  ],
[ '#', ' ', '#', '#', ' ', ' ', '#', '#', ' ', ' ', ' ', ' ', ' ', '#', '#', ' ', ' ', ' ', ' ', ' ', '#', '#', ' ', ' ', '#',  ],
[ '#', ' ', '#', ' ', ' ', ' ', '#', '#', '#', ' ', '#', '#', '#', ' ', ' ', ' ', ' ', '#', '#', ' ', '#', ' ', ' ', '#', ' ',  ],
[ '#', '#', '#', '#', ' ', ' ', ' ', ' ', '#', ' ', ' ', '#', '#', '#', '#', '#', '#', '#', ' ', ' ', '#', ' ', ' ', '#', ' ',  ],
[ ' ', '#', '#', ' ', ' ', '#', '#', ' ', ' ', '#', '#', '#', '#', '#', ' ', '#', '#', '#', ' ', '#', '#', ' ', '#', '#', '#',  ],
[ ' ', '#', ' ', ' ', '#', '#', '#', ' ', '#', '#', '#', '#', ' ', '#', ' ', ' ', '#', '#', '#', '#', '#', ' ', ' ', ' ', '#',  ],
[ ' ', '#', ' ', ' ', ' ', '#', '#', ' ', ' ', ' ', ' ', '#', ' ', '#', '#', '#', '#', ' ', ' ', ' ', ' ', '#', '#', '#', '#',  ],
[ ' ', ' ', '#', '#', '#', '#', ' ', ' ', '#', '#', '#', '#', ' ', ' ', '#', ' ', ' ', ' ', '#', ' ', ' ', ' ', '#', '#', '#',  ],
[ ' ', ' ', '#', '#', '#', ' ', '#', '#', '#', ' ', '#', ' ', '#', ' ', '#', '#', ' ', ' ', '#', ' ', '#', '#', '#', '#', ' ',  ],
[ '#', '#', ' ', ' ', ' ', ' ', '#', ' ', ' ', '#', ' ', ' ', ' ', '#', ' ', '#', ' ', '#', ' ', ' ', '#', '#', '#', ' ', '#',  ],
[ '#', '#', ' ', ' ', '#', '#', '#', '#', ' ', ' ', ' ', '#', '#', ' ', '#', ' ', '#', '#', ' ', ' ', ' ', ' ', ' ', '#', ' ',  ],
[ ' ', '#', '#', '#', '#', '#', '#', ' ', '#', '#', ' ', '#', ' ', ' ', '#', '#', '#', '#', ' ', '#', '#', '#', '#', '#', '#',  ],
[ ' ', ' ', '#', '#', ' ', ' ', '#', '#', ' ', ' ', ' ', ' ', ' ', ' ', ' ', '#', ' ', '#', ' ', '#', ' ', ' ', ' ', '#', ' ',  ],
[ '#', '#', ' ', '#', ' ', '#', '#', ' ', '#', ' ', ' ', '#', '#', ' ', '#', '#', '#', '#', ' ', '#', ' ', '#', ' ', ' ', ' ',  ],
[ '#', ' ', ' ', ' ', '#', ' ', '#', ' ', '#', ' ', ' ', '#', ' ', '#', ' ', ' ', '#', ' ', '#', ' ', ' ', ' ', '#', ' ', ' ',  ],
[ ' ', '#', ' ', '#', '#', ' ', '#', '#', '#', '#', '#', ' ', '#', '#', '#', ' ', '#', '#', ' ', '#', '#', '#', ' ', ' ', '#',  ],
[ ' ', ' ', '#', ' ', '#', ' ', '#', '#', ' ', '#', ' ', '#', ' ', '#', ' ', '#', ' ', ' ', '#', '#', '#', '#', ' ', ' ', '#',  ],
[ ' ', '#', '#', ' ', '#', ' ', ' ', '#', '#', ' ', ' ', ' ', ' ', '#', ' ', ' ', ' ', ' ', '#', '#', ' ', '#', ' ', '#', ' ',  ],
[ '#', ' ', '#', ' ', '#', ' ', ' ', '#', '#', '#', '#', '#', ' ', ' ', '#', '#', ' ', ' ', '#', '#', '#', '#', ' ', '#', '#',  ],
[ ' ', ' ', ' ', ' ', ' ', ' ', '#', '#', '#', '#', '#', ' ', ' ', '#', '#', '#', ' ', ' ', '#', '#', ' ', '#', ' ', ' ', ' ',  ]]
